10 12
#@...%#..###
#.....#.....
#.....##....
#...........
#####%#...##
#....#......
#....###....
#...........
#.$.....%...
############