10 12
# @ . . . % # . . # # #
# . . . . . # . . . . .
# . . . . . # # . . . .
# . . . . . . . . . . .
# # # # # % # . . . # #
# . . . . # . . . . . .
# . . . . # # # . . . .
# . . . . . . . . . . .
# . $ . . . . . % . . .
# # # # # # # # # # # #