15 15
#@...........%#
############..#
#..#.......#..#
#..#..%.....%.#
#..######.....#
#..............
# %.....#######
######........%
#....#.........
#....#.........
#....#..##..###
#....%..#.%%...
#.......#......
#..............
#...##########$ 
