15 15
# @ . . . . . . . . . . . % #
# # # # # # # # # # # # . . #
# . . # . . . . . . . # . . #
# . . # . . % . . . . . % . #
# . . # # # # # # . . . . . #
# . . . . . . . . . . . . . .
# % . . . . . . # # # # # # #
# # # # # # . . . . . . . . %
# . . . . # . . . . . . . . .
# . . . . # . . . . . . . . .
# . . . . # . . # # . . # # #
# . . . . % . . # . % % . . .
# . . . . . . . # . . . . . .
# . . . . . . . . . . . . . .
# . . . # # # # # # # # # # $ 
